............BBB.........BBB............
............BBB.........BBB............
............BBB.........BBB............
...GGGGGGGGGBBB........................
...GGGGGGGGGBBB...............SSSSSSSSS
...GGGGGGGGGBBB...............SSSSSSSSS
BBBGGGGGGGGG...........................
BBBGGGGGGGGG...........................
BBBGGGGGGGGG...........................
GGGGGGGGGGGG.........BBB...BBBBBBBBBB..
GGGGGGGGGGGG.........BBB...BBBBBBBBBB..
GGGGGGGGGGGG.........BBB...BBBBBBBBBB..
GGGGGGGGGGGGBBBBBBBBBBBB...BBB....BB...
GGGGGGGGGGGGBBBBBBBBB......BBB....BB...
GGGGGGGGGGGGBBBBBBBBB......BBB....BB...
GGGGGGGGGGGG......BBB.............BB...
GGGGGGGGGGGG......BBB.............BB...
GGGGGGGGGGGG......BBB.............BB...
...GGG............SSSSSSSSS......GGG...
...GGG............SSSSSSSSS......GGG...
...GGG............SSSSSSSSS......GGG...
...........................GGGGGGGGGGGG
...BBB..BBBB...............GGGGGGGGGGGG
...BBB..BBBB...............GGGGGGGGGGGG
BBBB...BBBBBB...BBBBBBBBBBBGGGGGGGGGGGG
BBBB...BBBBBB...BBBBBBBBBBBGGGGGGGGGGGG
BBBB...BBBBBB...BB.........GGGGGGGGGGGG
................BB.........GGGGGGGGGGGG
...............BBB.........GGGGGGGGGGGG
...............BBB...BBBBBBGGGGGGGGGGGG
BBB............BBB...BBBBBBGGGGGGGGG...
BBB..................BBBBBBGGGGGGGGG...
BBB........................GGGGGGGGG...
BBBBBB.....................GGGGGGGGG...
BBBBBB.....................GGGGGGGGG...
BBBBBB...........BBBBB.....GGGGGGGGG...
...BBBBBB........BXXXB.....BBB.........
...BBBBBB........BXXXB.....BBB.........
...BBBBBB........BXXXB.....BBB.........
0 0 0 0 0 0 0 0 0 0 0 0 0 0 1 1 1 1 3 3 