......SSS...BBB........................
......SSS...BBB.................B......
......SSS...BBB.................B......
......BBB...BBBGGG...BBBBBBBBBBBB......
......BBB...BBBGGG......BBBBBBBBB......
......BBB...BBBGGG......BBBBBBBBB......
...GGGGGG...BBBGGG..BBB..........SSSSSS
...GGGGGG...BBBGGG..BBB..........SSSSSS
...GGGGGG...BBBGGG..BBB..........SSSSSS
GGGGGGGGGGGGGGGGGGBBBBBBBBB.....BBBB...
GGGGGGGGGGGGGGGGGGBBBBBBBBB.....BBBB...
GGGGGGGGGGGGGGGGGGBBBBBBBBB.....BBBB...
......GGGGGG......SSSBBB.....BBBBBBB...
......GGGGGG......SSSBBB.....BBBBBBB...
......GGGGGGBBBBBB...BBB.....BBBBBBB...
BBBSSS......BBBBBB...........BBBB......
BBBSSS......BBBBBB.........BBBBBB......
BBB......BBB...............BBB.........
.BB......BBB...............BBB.........
.BB......BBB...........................
.BB...BBBBBB...........................
.BB...BBBBBB...........................
.BB...BBB..............................
.BB....................................
.BB....................................
......SSS..............................
......SSS..............................
......SSS..............................
BBB...BBB..............................
BBB...BBB..............................
BBB...BBB..............................
.BB...BBB..............................
.BB...BBB..............................
.BB...BBB..............................
.BB...BBB..............................
......BBB........BBBBB.................
......BBB........BXXXB.................
.................BXXXB.................
.................BXXXB.................
2 2 2 2 3 3 1 1 1 1 0 0 0 0 0 0 0 0 0 0 