............BBBBBB.....................
............BBBBBB.....................
............BBBBBB.....................
...GGGGGGBBBBBB........................
...GGGGGGBBBBBB........................
...GGGGGGBBBBBB........................
GGGGGGGGGGGGGGGGGGGGGGGG...............
GGGGGGGGGGGGGGGGGGGGGGGG...............
GGGGGGGGGGGGGGGGGGGGGGGG...............
GGGSSSBBBGGGBBBBBBBBBGGGGGGGGGGGGBBBSSS
GGGSSSBBBGGGBBBBBBBBBGGGGGGGGGGGGBBBSSS
GGG...BBBGGGBBBBBBBBBGGGGGGGGGGGGBBBSSS
GGGGGGBBBGGGGGGGGGSSSGGGGGGBBBSS.BBB...
GGGGGGBBBGGGGGGGGGSSSGGGGGGBBBSS.BBB...
GGGGGGBBBGGGGGGGGG...GGGGGGBBBSS.BBB...
...GGGGGGBBB...GGGGGGGGGGGGBBB...BBB...
...GGGGGGBBBSSSGGGGGGGGGGGGBBB...BBB...
...GGGGGGBBBSSSGGGGGGGGGGGGBBB...BBB...
...BBBBBBBBBBBBBBBGGGGGGBBBBBBB..GGGGGG
...BBBBBBBBBBBBBBBGGGGGGBBBBBBB..GGGGGG
...BBBBBBBBBBBBBBBGGGGGGBBBBBBB..GGGGGG
.SSSSSBBBBBB.........BBBBBB.........GGG
.SSSSSBBBBBB.........BBB............GGG
.SS...BBBBBB.........BBB............GGG
...BBB...BBB.........BBBGGGGGGBBBB..GGG
...BBB...BBB...SSSBBB...GGGGGGBBBB..GGG
...BBB...BBB...SSSBBB...GGGGGGBBBB..GGG
...BBB........BBBBBBBGGGGGGBBB......GGG
...BBB........BBBB...GGGGGGBBB......GGG
...BBB........BBBB...GGGGGGBBB......GGG
...BBBBBBB....BBBBGGGGGG...GGGBBBGGGGGG
...BBBBBBB....B...GGGGGGBBBGGGBBBGGGGGG
...BBBBBBB....B...GGGGGGBBBGGGBBBGGGGGG
......BBB...GGG.........BBBGGGBBBGGG...
......BBB...GGG.........BBBGGG...GGG...
......BBB...GGG..BBBBB..BBBGGG...GGG...
......BBB........BXXXB.....GGGGGGGGG...
.................BXXXB.....GGGGGGGGG...
.................BXXXB.....GGGGGGGGG...
0 0 1 1 1 1 1 1 1 1 1 1 3 3 3 3 3 3 3 3 