...BBB...BBB...BBB...BBB...BBB...BBB...
...BBB...BBB...BBB...BBB...BBB...BBB...
...BBB...BBB...BBB...BBB...BBB...BBB...
...BBB...BBB...BBB...BBB...BBB...BBB...
...BBB...BBB...BBB...BBB...BBB...BBB...
...BBB...BBB...BBB...BBB...BBB...BBB...
...SSS...SSS...SSS...SSS...SSS...SSS...
...SSS...SSS...SSS...SSS...SSS...SSS...
.......................................
............BBB.........BBB............
............BBB.........BBB............
BBB...BBB...BBB.........BBB...BBB...BBB
BBB...BBBBBBBBB...BBB...BBBBBBBBB...BBB
BBB...BBB...BBB...BBB...BBB...BBB...BBB
BBB...BBB...BBB...BBB...BBB...BBB...BBB
SSS...SSS...SSS...SSS...SSS...SSS...SSS
SSS...SSS...SSS...SSS...SSS...SSS...SSS
............SSS.........SSS............
GGGGGG......BBB...GGG...BBB......GGGGGG
GGGGGG......BBB...GGG...BBB......GGGGGG
GGGGGG......BBB...GGG...BBB......GGGGGG
GGGGGGGGGGG.BBBBBBGGGBBBBBBGGGGGGGGGGGG
GGGGGGGGGGG.BBBBBBGGGBBBBBBGGGGGGGGGGGG
GGGGGGGGGGG.BBB...GGG...BBBGGGGGGGGGGGG
GGGGGGGGGGGGGGGGGGGGGGGGGGGGGGGGGGGGGGG
GGGGGGGGGGGGGGGGGGGGGGGGGGGGGGGGGGGGGGG
GGGGGGGGGGGGGGGGGGGGGGGGGGGGGGGGGGGGGGG
............BBBGGGGGGGGGBBB............
BBB...BBB...BBBGGGGGGGGGBBB...BBB...BBB
BBB...BBB...BBBGGGGGGGGGBBB...BBB...BBB
...BBB...BBB......GGG......BBB...BBB...
...BBB...BBB......GGG......BBB...BBB...
...BBB...BBB......GGG......BBB...BBB...
...BBB...BBB...............BBB...BBB...
...BBB...BBB...............BBB...BBB...
...BBB...BBB.....BBBBB.....BBB...BBB...
...BBB...BBB.....BXXXB.....BBB...BBB...
.................BXXXB.................
.................BXXXB.................
1 1 1 1 3 3 3 3 3 3 3 3 0 0 0 0 2 2 2 2 