.........SSS.........SSS...............
.........SSS.........SSS...............
.........SSS.........SSS...............
...BBB...SSS.........BBB...BBB...BBB...
...BBB...SSS.........BBB...BBB...BBB...
...BBB...SSS.........BBB...BBB...BBB...
...BBB............BBBBBB...BBBSSSBBB...
...BBB............BBBBBB...BBBSSSBBB...
...BBB............BBBBBB...BBBSSSBBB...
.........BBB...............SSS.........
.........BBB...............SSS.........
.........BBB...............SSS.........
GGG......BBB......SSS......BBBGGGBBBSSS
GGG......BBB......SSS......BBBGGGBBBSSS
GGG......BBB......SSS......BBBGGGBBBSSS
GGGGGG.........BBB......SSS...GGG......
GGGGGG.........BBB......SSS...GGG......
GGGGGG.........BBB......SSS...GGG......
...BBBBBBBBBGGGGGGGGGSSS......GGGBBB...
...BBBBBBBBBGGGGGGGGGSSS......GGGBBB...
...BBBBBBBBBGGGGGGGGGSSS......GGGBBB...
.........SSSGGGBBB...BBB...BBB...BBB...
.........SSSGGGBBB...BBB...BBB...BBB...
.........SSSGGGBBB...BBB...BBB...BBB...
SSSBBB...SSS...BBB...BBB.........BBB...
SSSBBB...SSS...BBB...BBB.........BBB...
SSSBBB...SSS...BBB...BBB.........BBB...
...BBB...BBB...BBBBBBBBB...BBBSSSBBB...
...BBB...BBB...BBBBBBBBB...BBBSSSBBB...
...BBB...BBB...BBBBBBBBB...BBBSSSBBB...
...BBB...BBB...BBBBBBBBB...............
...BBB...BBB...BBBBBBBBB...............
...BBB...BBB...BBBBBBBBB...............
...BBB.....................BBB...BBB...
...BBB.....................BBB...BBB...
...BBB...........BBBBB.....BBB...BBB...
...BBB...BBB.....BXXXB.....BBBBBBBBB...
...BBB...BBB.....BXXXB.....BBBBBBBBB...
...BBB...BBB.....BXXXB.....BBBBBBBBB...
3 3 1 1 1 1 0 0 0 0 0 0 0 0 0 0 0 0 0 0 