.........BBB..................GGG......
.........BBB..................GGG......
.........BBB...............SSSGGG......
BBB..................GGG..SSSSS.....BBB
BBB..................GGG..SSSSS.....BBB
BBB...............SSSGGG..SSSSS.....BBB
............GGG..SSSSS.....SSSGGG......
............GGG..SSSSS........GGG......
.........SSSGGG..SSSSS........GGG......
........SSSSS.....SSSGGG...............
........SSSSS........GGG...............
........SSSSS........GGG...............
.........SSSGGG........................
............GGG........................
............GGG........................
.........GGG...GGG...GGG...GGG.........
.........GGG...GGG...GGG...GGG.........
.........GGGSSSGGG...GGGSSSGGG.........
SSSBBB.....SSSSS.......SSSSS.....BBBSSS
SSSBBB.....SSSSS.......SSSSS.....BBBSSS
SSSBBB.....SSSSS.......SSSSS.....BBBSSS
.........GGGSSSGGG...GGGSSSGGG.........
.........GGG...GGG...GGG...GGG.........
.........GGG...GGG...GGG...GGG.........
.......................................
.......................................
............SSS.........SSS............
BBB........SSSSS.......SSSSS........BBB
BBB........SSSSS.......SSSSS........BBB
BBB........SSSSS.......SSSSS........BBB
BBB......GGGSSSGGG...GGGSSSGGG......BBB
BBB......GGG...GGG...GGG...GGG......BBB
BBB......GGG...GGG...GGG...GGG......BBB
.......................................
.......................................
......BBB........BBBBB........BBB......
......BBBBBB.....BXXXB.....BBBBBB......
......BBBBBB.....BXXXB.....BBBBBB......
......BBBBBB.....BXXXB.....BBBBBB......
0 0 0 0 0 0 1 1 1 1 2 2 2 2 2 2 2 3 3 3 