.....................SSSSSS............
.....................SSSSSS............
.......................................
......SSSSSSSSSSSS............SSS......
......SSSSSSSSSSSS............SSS......
......SSS.....................SSS......
......SSS.........GGG...SSSSSSSSS......
......SSS.........GGG...SSSSSSSSS......
......SSS.........GGG......SSSSSS......
...SSS.........GGGSSS.........SSS......
...SSS.........GGGSSS.........SSS......
...SSS.........GGGSSS.........SSS......
............GGGSSSSSS.........SSSSSS...
............GGGSSSSSS............SSS...
............GGGSSSSSS............SSS...
...SSS...GGGSSSSSSSSS...SSS............
...SSS...GGGSSSSSSSSS...SSS............
...SSS...GGGSSSSSSSSS...SSS............
.....S...SSSSSS.........SSSSSS.........
.....S...SSSSSS.........SSSSSS.........
.....S...SSSSSS.........SSSSSS.........
SS..........SSS...SSSSSSSSS.......SS...
SS..........SSS...SSSSSSSSS.......SS...
SS..........SSS...SSSSSSSSS.......SS...
.....SSSS.........SSSSSSGGG......SSS...
.....SSSS.........SSSSSSGGG......SSS...
.....SSSS.........SSSSSSGGG......SSS...
...SSS............SSSGGG......SSSSSS...
...SSS............SSSGGG......SSSSSS...
...SSS............SSSGGG......SSSSSS...
...SSSSSSSSS......GGG......SSS.........
...SSSSSSSSS......GGG......SSS.........
........SSSS......GGG......SSS.........
........SSSS...............SSS......SSS
...........................SSS...SSSSSS
.................BBBBB...........SSSSSS
.................BXXXB.................
SSSSSS...........BXXXB.................
SSSSSS...........BXXXB.................
0 0 0 1 1 1 1 2 2 2 2 2 2 0 0 0 0 0 0 0 