.......................................
.........BBBBBBBBB......BBB............
.........BBBBBBBBB......BBB............
......BBBBBBBBBBBBBBBBBBBBBBBB.........
...BBBBBBBBBBBBBBBBBBBBBBBBBBB.........
...BBBBBBBBBBBBBBBBBBBBBBBBBBB.........
...GGGGGGGGGGGGGGGGGGGGGGGGBBBBBB......
...GGGGGGGGGGGGGGGGGGGGGGGGBBBBBB......
...GGGGGGGGGGGGGGGGGGGGGGGGBBBBBB......
GGGGGG..................GGGGGGBBBBBB...
GGGGGG..................GGGGGGBBBBBB...
GGGGGG..................GGGGGGBBBBBB...
GGG...SSS......SSS.........GGGGGGGGG...
GGG...SSS......SSS.........GGGGGGGGG...
GGG...SSS......SSS.........GGGGGGGGG...
GGG...SSS......SSS.........GGGGGGGGG...
GGG...SSS......SSS.........GGGGGGGGG...
GGG...SSS......SSS.........GGGGGGGGG...
GGG......GGG............GGGGGGBBBBBBB..
GGG......GGG............GGGGGGBBBBBBB..
GGG......GGG............GGGGGGBBBBBBB..
GGGGGGGGGGGGGGGGGGGGGGGGGGGBBBBBBBBBB..
GGGGGGGGGGGGGGGGGGGGGGGGGGGBBBBBBBBBB..
GGGGGGGGGGGGGGGGGGGGGGGGGGGBBBBBBBBBB..
BBBGGGGGGBBBBBBGGGGGGGGGBBBBBBBBBBBB...
BBBGGGGGGBBBBBBGGGGGGGGGBBBBBBBBBBBB...
BBBGGGGGGBBBBBBGGGGGGGGGBBBBBBBBBBBB...
...BBBBBBBBBBBBBBBBBBBBBBBBBBBBBB...SSS
...BBBBBBBBBBBBBBBBBBBBBBBBBBBBBB...SSS
...BBBBBBBBBBBBBBBBBBBBBBBBBBBBBB...SSS
SSS...BBBSSSBBBBBBBBBBBBBBBBBBB.....SSS
SSS...BBBSSSBBBBBBBBBBBBBBBBBBB.....SSS
SSS...BBBSSSBBBBBBBBBBBBBBBBBBB.....SSS
...SSSBBBBBBSSS...............SSSSSSSSS
...SSSBBBBBBSSS...............SSSSSSSSS
...SSSBBB...SSS..BBBBB........SSSSSSSSS
.................BXXXB.................
.................BXXXB.................
.................BXXXB.................
2 2 2 2 2 2 2 2 1 1 0 0 0 0 0 0 3 3 3 3 