.........WWW............WWW............
.........WWW............WWW............
.........WWW............WWW............
WWWWWW...WWW...WWWWWWWWWWWW...WWWWWWWWW
WWWWWW...WWW...WWWWWWWWWWWW...WWWWWWWWW
WWWWWW...WWW...WWWWWWWWWWWW...WWWWWWWWW
GGGGGGBBB......BBB......WWW...WWWGGGWWW
GGGGGGBBB......BBB......WWW...WWWGGGWWW
GGGGGGBBB......BBB......WWW...WWWGGGWWW
GGGWWWWWWWWWWWW...SSS......BBBGGGGGGGGG
GGGWWWWWWWWWWWW...SSS......BBBGGGGGGGGG
GGGWWWWWWWWWWWW...SSS......BBBGGGGGGGGG
GGGGGG...WWW......WWW...WWWWWWWWWWWWGGG
GGGGGG...WWW......WWW...WWWWWWWWWWWWGGG
GGGGGG...WWW......WWW...WWWWWWWWWWWWGGG
WWWWWW...WWW...WWWWWW......WWW.........
WWWWWW...WWW...WWWWWW......WWW.........
WWWWWW...WWW...WWWWWW......WWW.........
......BBBGGGBBB...BBBGGG...WWW......WWW
......BBBGGGBBB...BBBGGG...WWW......WWW
......BBBGGGBBB...BBBGGG...WWW......WWW
...WWWWWWGGGWWWWWWWWWWWW...GGGBBB...WWW
...WWWWWWGGGWWWWWWWWWWWW...GGGBBB...WWW
...WWWWWWGGGWWWWWWWWWWWW...GGGBBB...WWW
BBB......BBB......WWW...GGGGGGWWW...WWW
BBB......BBB......WWW...GGGGGGWWW...WWW
BBB......BBB......WWW...GGGGGGWWW...WWW
WWWWWW...WWWWWW...WWWBBBWWWWWWWWW......
WWWWWW...WWWWWW...WWWBBBWWWWWWWWW......
WWWWWW...WWWWWW...WWWBBBWWWWWWWWW......
......BBB...GGGGGG......GGGWWW......WWW
......BBB...GGGGGG......GGGWWW......WWW
......BBB...GGGGGG......GGGWWW......WWW
...WWWWWWWWWGGG............WWW...WWWWWW
...WWWWWWWWWGGG............WWW...WWWWWW
...WWWWWWWWWGGG..BBBBB.....WWW...WWWWWW
...WWW...........BXXXB.................
...WWW...........BXXXB.................
...WWW...........BXXXB.................
2 2 2 1 1 1 1 1 1 1 1 3 3 3 3 3 3 2 2 2 