.......................................
.......................................
............BBB.........BBB............
...BBBBBBBBBBBB.........BBBBBBBBBBBB...
...BBBBBBBBBBBB.........BBBBBBBBBBBB...
...BBBBBBBBBBBB.........BBBBBBBBBBBB...
...BBB............BBB............SSS...
...BBB............BBB............SSS...
...BBB............BBB............SSS...
...SSS...BBB...............BBB...BBBBBB
...SSS...BBB...............BBB...BBBBBB
...SSS...BBB...............BBB...BBBBBB
...BBB......GGG...SSS...GGG......SSSBBB
...BBB......GGG...SSS...GGG......SSSBBB
...BBB......GGGSSSSSSSSSGGG......SSSBBB
...BBB......GGGGGGGGGGGGGGG......SSSBBB
............GGGGGGGGGGGGGGG.........BBB
............GGGGGGGGGGGGGGG.........BBB
BBB.........GGGGGGGGGGGGGGG.........BBB
BBBSSS......GGGGGGGGGGGGGGG......BBBBBB
BBBSSS......GGGGGGGGGGGGGGG......BBBBBB
BBBSSS......GGGSSSSSSSSSGGG......BBB...
BBBSSS......GGG...SSS...GGG......BBB...
BBBSSS......GGG...SSS...GGG......BBB...
BBBBBB...BBB...............BBB...SSS...
BBBBBB...BBB...............BBB...SSS...
BBBBBB...BBB...............BBB...SSS...
BBBSSS............BBB............BBB...
BBBSSS............BBB............BBB...
BBBSSS............BBB............BBB...
BBBBBBBBBBBBBBB.........BBBBBBBBBSSSSSS
BBBBBBBBBBBBBBB.........BBBBBBBBBSSSSSS
BBBBBBBBBBBBBBB.........BBBBBBBBBSSSSSS
BBBBBB......BBB.........BBB......BBB...
BBBBBB...........................BBB...
BBBBBB...........BBBBB...........BBB...
BBBBBB...........BXXXB.................
BBBBBB...........BXXXB.................
BBBBBB...........BXXXB.................
2 2 2 2 2 2 2 2 1 1 1 1 1 1 1 1 3 3 3 3 