.......................................
.......................................
.......................................
GGGGGG.........B..BBBBBB.........GGGGGG
GGGGGG......BBBB..BBBBBBBBB......GGGGGG
GGGGGG......BBBB..BBBBBBBBB......GGGGGG
GGG........BBBBB..BBBBBBBBBB........GGG
GGG........BBBBB..BBBBBBBBBB........GGG
GGG........BBBBB..BBBBBBBBBB........GGG
.........BBBBBBG..BBBGGGBBBBBB.........
.........BBBBBBG..BBBGGGBBBBBB.........
.........BBBBBBG..BBBGGGBBBBBB.........
.........BBBGGGG..BBBGGGGGGBBB.........
.........BBBGGGG..BBBGGGGGGBBB.........
.........BBBGGGG..BBBGGGGGGBBB.........
GGG......BBBBBBB.........BBBBB......GGG
GGG......BBBBBBB.........BBBBB......GGG
GGG......BBBBBBB..BBBBBB..BBBB......GGG
GGGGGG......BBBGGGBBBGGG..B......GGGGGG
GGGGGG......BBBGGGBBBGGG..B......GGGGGG
GGGGGG......BBBGGGBBBGGG..B......GGGGGG
WWWWWWWWW...BBBBBBBBBBBB..B...WWWWWWWWW
WWWWWWWWW...BBBBBBBBBBBB..B...WWWWWWWWW
WWWWWWWWW...BBBBBBBBBBBB..B...WWWWWWWWW
.............BB.BB.BB.BB..B............
.............BB.BB.BB.BB..B............
.............BB.BB.BB.BB.BB............
............BB.BB.BB.BB.BB.............
............BB.BB.BB.BB.BB.............
............BB.BB.BB.BB.BB.............
.SS.SS.SS.....................SS.SS.SS.
.SS.SS.SS.....................SS.SS.SS.
.SS.SS.SS.....................SS.SS.SS.
BB.BB.BB.......................BB.BB.BB
BB.BB.BB.......................BB.BB.BB
BB.BB.BB.........BBBBB.........BB.BB.BB
SS.SS.SS..SS.....BXXXB.....SS..SS.SS.SS
SS.SS.SS..SS.....BXXXB.....SS..SS.SS.SS
SS.SS.SS..SS.....BXXXB.....SS..SS.SS.SS
2 2 2 2 2 2 2 2 2 2 1 1 1 1 3 3 3 3 3 3 