.......................................
.......................................
.......................................
......SSSGGGSSS........................
......SSSGGGSSS........................
......SSSGGGSSS........................
.........GGG...GGG.....................
.........GGG...GGGSSS..................
.........GGG...GGGSSS..................
...GGG............GGG..................
...GGG............GGGBBB...............
...GGG............GGGBBB...............
...GGGGGG......GGG...GGG...............
...GGGGGG......GGG...GGGSSS............
...GGGGGG......GGG...GGGSSS............
...GGG...GGG...GGG......GGG............
...GGG...GGG...GGG......GGGBBB.........
...GGG...GGG...GGG......GGGBBB.........
...GGG......GGG.........GGGGGG.........
...GGG......GGG.........GGGGGGSSS......
...GGG......GGG.........GGGGGGSSS......
...GGG...............GGGGGGGGGGGG......
...GGG...............GGGGGGGGGGGGBBB...
...GGG...............GGGGGGGGGGGGBBB...
......GGG.........GGG...GGGGGGGGGGGG...
......GGG.........GGG...GGGGGGGGGGGG...
......GGG.........GGG...GGGGGGGGGGGG...
BBB......GGG......GGG......GGGGGGGGGSSS
BBB......GGG......GGG......GGGGGGGGGSSS
BBB......GGG......GGG......GGGGGGGGGSSS
BBBBBB...............GGG...GGGGGGGGGGGG
BBBBBB...............GGG...GGGGGGGGGGGG
BBBBBB...............GGG...GGGGGGGGGGGG
SSSBBBBBB...............GGG...GGGGGGGGG
SSSBBBBBB...............GGG...GGGGGGGGG
SSSBBBBBB........BBBBB..GGG...GGGGGGGGG
SSSSSSBBBBBB.....BXXXB..GGG......GGGGGG
SSSSSSBBBBBB.....BXXXB..GGG......GGGGGG
SSSSSSBBBBBB.....BXXXB..GGG......GGGGGG
0 0 0 0 0 0 0 0 0 0 0 0 0 0 0 0 1 1 3 3 