.........SSS.........SSS...............
.........SSS.........SSS...............
.........SSS.........SSS...............
...BBB...SSS.........BBB...BBB...BBB...
...BBB...SSS.........BBB...BBB...BBB...
...BBB...SSS.........BBB...BBB...BBB...
...BBB............BBBBBB...BBBSSSBBB...
...BBB............BBBBBB...BBBSSSBBB...
...BBB............BBBBBB...BBBSSSBBB...
.........BBB...............SSS.........
.........BBB...............SSS.........
.........BBB...............SSS.........
.........BBB......SSS......BBB...BBBSSS
.........BBB......SSS......BBB...BBBSSS
.........BBB......SSS......BBB...BBBSSS
...............BBB......SSS............
...............BBB......SSS............
...............BBB......SSS............
...BBBBBBBBB.........SSS.........BBB...
...BBBBBBBBB.........SSS.........BBB...
...BBBBBBBBB.........SSS.........BBB...
.........SSS...BBB...BBB...BBB...BBB...
.........SSS...BBB...BBB...BBB...BBB...
.........SSS...BBB...BBB...BBB...BBB...
SSSBBB...SSS...BBB...BBB.........BBB...
SSSBBB...SSS...BBB...BBB.........BBB...
SSSBBB...SSS...BBB...BBB.........BBB...
...BBB...BBB...BBBBBBBBB...BBBSSSBBB...
...BBB...BBB...BBBBBBBBB...BBBSSSBBB...
...BBB...BBB...BBBBBBBBB...BBBSSSBBB...
...BBB...BBB...BBBBBBBBB...............
...BBB...BBB...BBBBBBBBB...............
...BBB...BBB...BBBBBBBBB...............
...BBB.....................BBB...BBB...
...BBB.....................BBB...BBB...
...BBB...........BBBBB.....BBB...BBB...
...BBB...BBB.....BXXXB.....BBBBBBBBB...
...BBB...BBB.....BXXXB.....BBBBBBBBB...
...BBB...BBB.....BXXXB.....BBBBBBBBB...
