............BBBBBB.....................
............BBBBBB.....................
............BBBBBB.....................
............BBB.........SSSSSSSSS......
SSS...BBB...BBB.........SSSSSSSSS......
SSS...BBB...BBB...............SSS......
SSS...BBB.........BBB..................
SSS...BBB.........BBB..................
BBB...BBB.........BBB..................
BBB...BBBBBBBBB...BBBBBB...WWWWWW...WWW
BBB...BBBBBBBBB...BBBBBB...WWWWWW...WWW
BBB...BBBBBBBBB...BBBBBB...WWWWWW...WWW
BBB........................WWW.........
...........................WWW.........
...........................WWW.........
............WWWWWW...WWWWWWWWW...BBBBBB
......BBB...WWWWWW...WWWWWWWWW...BBBBBB
......BBB...WWWWWW...WWWWWWWWW...BBBBBB
BBBBBB......WWWBBB...BBBBB.............
BBBBBB......WWWBBB...BBBBB.............
BBBBBB......WWWBBB...BBBBB.............
............WWW.................SSS....
............WWW.................SSS....
............WWW.................SSS....
WWWWWWWWW...WWW...SSS...BBB.....S......
WWWWWWWWW...WWW...SSS...BBB.....S......
WWWWWWWWW...WWW...SSS...BBB.....S......
................................SBBBBBB
................................SBBBBBB
.........BBBBBB.................SBBBBBB
............BBBBBBBBBBBBBBB............
............BBBBBBBBBBBBBBBBBB.........
............BBB.........BBBBBB.........
BBBBBBBBB..................BBBBBB......
BBBBBBBBB.....................BBB......
BBBBBB...........BBBBB........BBB......
BBB..............BXXXB.................
BBB..............BXXXB.................
.................BXXXB.................
0 0 0 0 0 0 0 0 0 0 0 0 0 0 0 0 0 0 0 0 