........................SSSSSSSSSGGG...
........................SSSSSSSSSGGG...
........................SSSSSSSSSGGG...
...BBB..................SSS......SSS...
...BBB..................SSS......SSS...
...BBB..................SSS......SSS...
BBBGGGBBB.........BBBBBBBBBBBB...SSS...
BBBGGGBBB.........BBBBBBBBBBBB...SSS...
BBBGGGBBB.........BBBBBBBBBBBB...SSS...
...BBBGGGBBB......BBB...GGGBBBSSSSSS...
...BBBGGGBBB......BBB...GGGBBBSSSSSS...
...BBBGGGBBB......BBB...GGGBBBSSSSSS...
......BBB...GGGSSSBBBGGG...BBB.........
......BBB...GGGSSSBBBGGG...BBB.........
......BBB...GGGSSSBBBGGG...BBB.........
............SSS...BBBSSSBBBBBB.........
............SSS...BBBSSSBBBBBB.........
............SSS...BBBSSSBBBBBB.........
......BBBBBBSSSBBB...SSS...............
......BBBBBBSSSBBB...SSS...............
......BBBBBBSSSBBB...SSS...............
......BBB...GGGBBBSSSGGG...............
......BBB...GGGBBBSSSGGG...............
......BBB...GGGBBBSSSGGG...............
SSSSSSSSSGGG...BBB......BBBBBB.........
SSSSSSSSSGGG...BBB......BBBBBB.........
SSSSSSSSSGGG...BBB......BBBBBB.........
SSS...BBBBBBBBBBBB......BBBSSSSSS......
SSS...BBBBBBBBBBBB......BBBSSSSSS......
SSS...BBBBBBBBBBBB......BBBSSSSSS......
SSS......SSS...............SSSBBBBBB...
SSS......SSS...............SSSBBBBBB...
SSS......SSS...............SSSBBBBBB...
GGGSSSSSSSSS..................BBBSSSSSS
GGGSSSSSSSSS..................BBBSSSSSS
GGGSSSSSSSSS.....BBBBB........BBBSSSSSS
.................BXXXB...........SSSSSS
.................BXXXB...........SSSSSS
.................BXXXB...........SSSSSS
3 3 3 3 0 0 2 2 2 2 2 2 1 1 1 1 1 1 1 1 