.............B...B.....................
............BB..BB.....................
............BB..BB.....................
.B..B..B...BB..BB.....BB.BB............
BB.BB.BB...BB..BB.....BB.BB............
BB.BB.BB...BB..BB.....BB.BB............
BB.BB.BB.BBBBBB.......BB.BBBBB.........
BB.BB.BB.BBBBBB.......BB.BBBBB.........
BB.BB.BB.BBBBBB.......BB.BBBBB.........
.BB.BB...BBBBB.......BBB.BBBBBBB.......
.BB.BB...BBBBB.......BBB.BBBBBBB.......
.BB.BB...BBBBB.......BBB.BBBBBBB.......
...BB....BBB.BBB...BB.BBBBBBBBBB.......
...BB....BBB.BBB...BB.BBBBBBBBBB.......
...BB....BBB.BBB...BB.BBBBBBBBBB.......
...BB..BB.....BBBB.BBB..BB.BBBBB.......
...BB..BB.....BBBB.BBB..BB.BBBBB.......
...BB..BB.....BBBB.BBB..BB.BBBBB.......
...BB........BBBBBBBBB....BB.BBB.......
...BB........BBBBBBBBB....BB.BBB.......
...BB........BBBBBBBBB....BB.BBB.......
....BB.....BB..BBBBBBB....BB.BBB.......
....BB.....BB..BBBBBBB....BB.BBB.......
....BB.....BB..BBBBBBB....BB.BBBBBBBBBB
....BBBBBBBBB..BBBBBBBBB..BB.BB.BBBBBBB
....BBBBBBB....BBBBBBBBB..BB.BB....BBBB
....BB.........BBBBBBBBB..BB.BB....BBBB
....BB........BBB.BBB.BBB.BB.BB..BB..BB
....BB........BBB.BBB.BBB.BB.BB..BB..BB
....BB........BBB.BBB.BBB.BB.BB..BB..BB
.....BB.....BBB.BBB.BBBBBB.......BB....
.....BB.....BBB.BBB.BBBBBB.......BB....
.....BB.....BBB.BBB.BBBBBB.......BB....
.....BB...BBB..........BBBBB....BB.....
.....BB...BBB..........BBBBB....BB.....
.....BB...BBB....BBBBB.BBBBB....BB.....
.....BB...BB.....BXXXB....BBBBBB.......
.....BB...BB.....BXXXB....BBBBBB.......
.....BB...BB.....BXXXB....BBBBBB.......
2 2 2 2 1 1 1 1 1 1 3 3 3 3 3 3 3 3 3 3 