............SSS............SSS.........
............SSS............SSS.........
............SSS............SSS.........
...SSS.........SSS......SSSGGGGGG......
...SSS.........SSS......SSSGGGGGG......
...SSS.........SSS......SSSGGGGGG......
......SSS............SSSGGG...SS.......
......SSS............SSSGGGSSSSS.......
......SSS............SSSGGGSSSSS.......
.........SSS...GGGGGGGGGGGGGGG....SS...
.........SSS...GGGGGGGGGGGGGGG....SS...
.........SSS...GGGGGGGGGGGGGGG....SS...
...SS.......SSSGGGGGGSSSGGG......SSS...
...SS.......SSSGGGGGGSSSGGG......SSS...
...SS.......SSSGGGGGGSSSGGG......SSS...
...SSSSS.GGG...SSSGGGGGGSSS.......SS...
...SSSSS.GGG...SSSGGGGGGSSS.......SS...
......SS.GGG...SSSGGGGGGSSS.......SS...
......GGGGGGGGGGGGGGG......SSS.........
......GGGGGGGGGGGGGGG......SSS.........
......GGGGGGGGGGGGGGG......SSS.........
......SS.GGG...SSSGGG.........SSS......
...SSSSS.GGG...SSSGGG.........SSS......
...SSSSS.GGG...SSSGGG.........SSS......
...GGGGGGGGGSSS...SSS............SSS...
...GGGGGGGGGSSS...SSS...SSS......SSS...
...GGGGGGGGGSSS...SSS...SSS......SSS...
GGGGGGGGGSSS.............SS............
GGGGGGGGGSSS.............SS............
GGGGGGGGGSSS.............SS............
......SSS..........................SSSS
......SSS..........................SSSS
......SSS..........................SSSS
..............................SS.......
..............................SS.......
.................BBBBB.....SSSSS.......
SS...............BXXXB.....SSSSS.......
SS....SSS........BXXXB.................
SS....SSS........BXXXB.................
1 1 1 1 3 3 3 3 3 3 3 3 2 2 2 2 1 1 1 1 