.......................................
.......................................
.......................................
GGGGGG.........BBBBBBBBB.........GGGGGG
GGGGGG......BBBBBBBBBBBBBBB......GGGGGG
GGGGGG......BBBBBBBBBBBBBBB......GGGGGG
GGG........BBBBBBBBBBBBBBBBB........GGG
GGG........BBBBBBBBBBBBBBBBB........GGG
GGG........BBBBBBBBBBBBBBBBB........GGG
.........BBBBBBGGGBBBGGGBBBBBB.........
.........BBBBBBGGGBBBGGGBBBBBB.........
.........BBBBBBGGGBBBGGGBBBBBB.........
.........BBBGGGGGGBBBGGGGGGBBB.........
.........BBBGGGGGGBBBGGGGGGBBB.........
.........BBBGGGGGGBBBGGGGGGBBB.........
GGG......BBBBBBBBBBBBBBBBBBBBB......GGG
GGG......BBBBBBBBBBBBBBBBBBBBB......GGG
GGG......BBBBBBBBBBBBBBBBBBBBB......GGG
GGGGGG......BBBGGGBBBGGGBBB......GGGGGG
GGGGGG......BBBGGGBBBGGGBBB......GGGGGG
GGGGGG......BBBGGGBBBGGGBBB......GGGGGG
WWWWWWWWW...BBBBBBBBBBBBBBB...WWWWWWWWW
WWWWWWWWW...BBBBBBBBBBBBBBB...WWWWWWWWW
WWWWWWWWW...BBBBBBBBBBBBBBB...WWWWWWWWW
.............BB.BB.BB.BB.BB............
.............BB.BB.BB.BB.BB............
.............BB.BB.BB.BB.BB............
............BB.BB.BB.BB.BB.............
............BB.BB.BB.BB.BB.............
............BB.BB.BB.BB.BB.............
.SS.SS.SS.....................SS.SS.SS.
.SS.SS.SS.....................SS.SS.SS.
.SS.SS.SS.....................SS.SS.SS.
BB.BB.BB.......................BB.BB.BB
BB.BB.BB.......................BB.BB.BB
BB.BB.BB.........BBBBB.........BB.BB.BB
SS.SS.SS..SS.....BXXXB.....SS..SS.SS.SS
SS.SS.SS..SS.....BXXXB.....SS..SS.SS.SS
SS.SS.SS..SS.....BXXXB.....SS..SS.SS.SS
2 2 2 2 2 2 2 2 2 2 1 1 1 1 3 3 3 3 3 3 