.......................................
.......................................
.......................................
.......................................
...............BBBBBB.........SSS......
...............BBBBBB.........SSS......
...............GGGGGG.........GGG......
...SSSSSS...BBBGGGGGGSSS...BBBGGGBBB...
...SSSSSS...BBBGGGGGGSSS...BBBGGGBBB...
...GGGGGG...GGGGGGGGGGGG...GGGGGGGGG...
BBBGGGGGGBBBGGGGGGGGGGGGBBBGGGGGGGGGBBB
BBBGGGGGGBBBGGGGGGGGGGGGBBBGGGGGGGGGBBB
GGGGGGGGGGGGGGGGGGGGGGGGGGGGGGGGGGGGGGG
GGGGGGGGGGGGGGGGGGGGGGGGGGGGGGGGGGGGGGG
GGGGGGGGGGGGGGGGGGGGGGGGGGGGGGGGGGGGGGG
SSSGGGWWWGGGGGGGGGGGGGGGWWWGGGGGGGGGGGG
SSSGGGWWWGGGGGGGGGGGGGGGWWWGGGGGGGGGGGG
SSSGGGWWWGGGGGGGGGGGGGGGWWWGGGGGGGGGGGG
GGGGGGWWWWWWWWWGGGGGGGGGWWWWWWWWWGGGSSS
GGGGGGWWWWWWWWWGGGGGGGGGWWWWWWWWWGGGSSS
GGGGGGWWWWWWWWWGGGGGGGGGWWWWWWWWWGGGSSS
GGGGGGGGGGGGWWWGGGSSSGGGGGGGGGWWWGGGGGG
GGGGGGGGGGGGWWWGGGSSSGGGGGGGGGWWWGGGGGG
GGGGGGGGGGGGWWWGGGSSSGGGGGGGGGWWWGGGGGG
GGGGGGGGGGGGGGGGGGGGGGGGGGGGGGGGGGGGGGG
GGGGGGGGGGGGGGGGGGGGGGGGGGGGGGGGGGGGGGG
GGGGGGGGGGGGGGGGGGGGGGGGGGGGGGGGGGGGGGG
GGGGGGGGGGGGGGGBBBBBBGGGGGGGGGGGGGGGSSS
GGGGGGGGGGGGGGGBBBBBBGGGGGGGGGGGGGGGSSS
GGGGGGGGGGGGGGG......GGGGGGGGGGGGGGG...
SSSGGGGGGGGG.........BBBGGGGGGGGGSSS...
SSSGGGGGGGGG.........BBBGGGGGGGGGSSS...
...GGGGGGGGG............GGGGGGGGG......
...SSSBBBBBB............BBBBBBBBB......
...SSSBBBBBB............BBBBBBBBB......
.................BBBBB.................
.................BXXXB.................
.................BXXXB.................
.................BXXXB.................
0 0 0 0 1 1 1 1 1 1 1 1 2 2 2 2 3 3 3 3 