...GGGGGG........................GGG...
...GGGGGG........................GGG...
...GGGGGG........................GGG...
GGGGGG..........BBBBBBB.............GGG
GGGGGG........BBBBBBBBBBBB..........GGG
GGGGGG.......BBBBBBBBBBBBBBB........GGG
GGG........BBBBBBBBBBBBBBBBBBB......SSS
GGG........BBBBBBBBBBBBBBBBBBBB........
GGG.......BBBBBBBBBBBBBBBBBBBBBBB......
SSS......BBBBBBBBBBBBBBBBBBBBBBBBB.....
.........BBBBBBBBBBBBBBBBBBBBBBBBB.....
.........BBBBBBBBBBBBBBBBBBBBBBBBB.....
........BBBB.........BBBBBBBBB...B.....
........B...............BBBBBB...B.....
WWW.....B...............BBBBBB...B.....
WWW....BB...S.....S.....BBBBB..........
WWW....BB...S.....S.....BBBB...........
.......BB...............BBBB...........
......BBB...............BBBB.....WWWWWW
......BBB...BBBBBB......BBBBB....WWWWWW
.....BBBB...BBBBBB......BBBBB....WWWWWW
.....BBBBBBBBBBBBBBBBBBBBBBBBB.........
.....BBBBBBBBBBBBBBBBBBBBBBBBB.........
.....BBBBBBBBBBBBBBBBBBBBBBBBB.........
....BBBBBBBBBBBBBBBBBBBBBBBBBBBB.......
....BBBBBBBBBBBBBBBBBBBBBBBBBBBB.......
....BBBBBBBBBBBBBBBBBBBBBBBBBBBB.......
...BBBBBBBBBBBBBBBBBBBBBBBBBBBBBB......
...BBBBBBBBBBBBBBBBBBBBBBBBBBBBBB......
.........BBBBBBBBBBBBBBBBBB............
...BBBBBB...BBBBBBBBBBBB...BBBBBB...GGG
...BBBBBBBBB...BBBBBB...BBBBBBBBB...GGG
...BBBBBBBBB............BBBBBBBBB...GGG
......BBBBBB............BBBBBB...GGGGGG
.................................GGGGGG
.................BBBBB...........GGGGGG
SSS..............BXXXB........GGGGGGSSS
SSS..............BXXXB........GGGGGGSSS
SSS..............BXXXB........GGGGGGSSS
3 3 3 3 3 3 3 3 3 3 1 1 1 1 1 0 0 3 3 3 