................BB...BB.GGGGGG.........
................BB...BB.GGGGGG.........
................BB...BB.GGGGGG.........
...BB...SS..B.............BGGGBB...BGGG
...BB...SS..B.............BGGGBB...BGGG
...BB...SS..B.............BGGGBB...BGGG
...BB...SS..B.....BBB.....BGGGBB...BGGG
...BB...SS..B.....BBB.....BGGGBB...BGGG
...BB...SS..B.....BBB.....BGGGBB...BGGG
...BBB......BBB...SSS...BBBGGG...BBBGGG
...BBB......BBB...SSS...BBBGGG...BBBGGG
...BBB......BBB...SSS...BBBGGG...BBBGGG
...........BSSS...BBB...BBBSS....GGGGGG
...........B......BBB...BBBSS....GGGGGG
..................BBB......SS....GGGGGG
BBBBBBB........GGGBBBGGG........BBBBBBB
BBBBBBB........GGGBBBGGG........BBBBBBB
BBBBBBB........GGGBBBGGG........BBBBBBB
.............BBGGGGGGGGGBB.............
.............BBGGGGGGGGGBB.............
.............BBGGGGGGGGGBB.............
SSSBBBBBB...BBBGGGGGGGGGBBB..BBBBBBBSSS
SSSBBBBBB...BBBGGGGGGGGGBBB..BBBBBBBSSS
SSSBBBBBB......GGGGGGGGG.....BBBBBBBSSS
SSSSSSSSS.........GGG..........SSSSSSSS
..................GGG..................
............BBB...GGG...BBB............
...BBB......BBB.........BBB............
...BBB......BBB.........BBB............
...BBB......BBB.........BBB............
...BBBB........BBB...BBB........BBBBGGG
...BBBB........BBB...BBB........BBBBGGG
...BBBB.........................BBBBGGG
......BBB.....................GGGGGGGGG
..............................GGGGGGGGG
.................BBBBB........GGGGGGGGG
.................BXXXB...........GGGGGG
......BBB........BXXXB........BBBGGGGGG
......BBB........BXXXB........BBBGGGGGG
2 2 2 2 2 2 2 1 1 0 0 0 0 0 0 0 0 0 3 3 