.......................................
.......................................
.......................................
.......................................
.......................................
.......................................
.........BBB...............BBB.........
.........BBB...............BBB.........
.........BBB...............BBB.........
...BBB...BBB...BBB...BBB...BBB...BBB...
...BBB...BBB...BBB...BBB...BBB...BBB...
...BBB...BBB...BBB...BBB...BBB...BBB...
...BBBBBBBBB...............BBBBBBBBB...
...BBBBBBBBB...............BBBBBBBBB...
.........BBB...............BBB.........
.........BBB...BBBSSSBBB...BBB.........
.........BBB...BBBSSSBBB...BBB.........
.........BBB...BBBSSSBBB...BBB.........
SSS............SSS...SSS............SSS
SSS.................................SSS
SSS.................................SSS
.......................................
...............BBB...BBB...............
...............BBB...BBB...............
...............BBB...BBB...............
...............BBB...BBB...............
...............BBB...BBB...............
.........BBB...............BBB.........
.........BBB...............BBB.........
.........BBB......BBB......BBB.........
...BBB...BBB...SSSSSSSSS...BBB...BBB...
...BBB...BBB...SSSSSSSSS...BBB...BBB...
...BBB...BBB...............BBB...BBB...
...BBB...BBB...............BBB...BBB...
...BBBBBBBBB...............BBBBBBBBB...
...BBBBBBBBB.....BBBBB.....BBBBBBBBB...
...BBB...........BXXXB...........BBB...
...BBB...........BXXXB...........BBB...
.................BXXXB.................
3 3 3 3 3 3 3 3 0 0 0 0 0 0 3 3 1 1 1 1 