......BBB......BBB.........BBB.........
......BBB......BBB.........BBB.........
......BBB......BBB...BBB...BBB.........
GGGBBBBBBBBB...BBB.........BBBBB.......
GGGBBBBBBBBB...BBB.........BBBBB.......
GGGBBBBBBBBB...BBB...SSS...BBBBB.......
GGGGGGGGG......BBB...BBB...BBB.....BBB.
GGGGGGGGG............BBB...........BBB.
GGGGGGGGG............BBB...........BBB.
GGGWWWWWWWWWWWWWWWWWWWWWWWWWWWWWW...WWW
GGGWWWWWWWWWWWWWWWWWWWWWWWWWWWWWW...WWW
GGGWWWWWWWWWWWWWWWWWWWWWWWWWWWWWW...WWW
...BBB.................................
...BBB............BBBBBB...............
...BBB............BBBBBB...............
......BBB.......BBBBBBBBBBBBBBBBBSSSSSS
......BBB.......BBBBBBBBBBBBBBBBBSSSSSS
......BBB.......BBBBBBBB...BBB.........
BBBBBB...BBB....BBBBBBBBGGGBBB......BBB
BBBBBB...BBB....BBBBBBBBGGGBBB......BBB
BBBBBB...BBB....BBBBBBBBGGGBBBSSSSSSBBB
.........SSS.........GGGGGGGGGGGG......
.........SSS.........GGGGGGGGGGGG......
.........SSS...SSS...GGGGGGGGGGGG......
WWWWWW...WWWWWWWWWWWWWWW...WWWWWWWWWWW.
WWWWWW...WWWWWWWWWWWWWWW...WWWWWWWWWWW.
WWWWWW...WWWWWWWWWWWWWWW...WWWWWWWWWWW.
GGGGGG.................................
GGGGGG............BBBBBB...............
GGGGGG............BBBBBB...............
GGGGGGBBB.............BB.........BBB...
GGGGGGBBB.............BB...SSSBBBBBB...
GGGGGGBBB.............BB...SSSBBBBBB...
GGG...BBB..................BBB...BBB...
GGGSSSBBB........................BBB...
GGGSSSBBB........BBBBB...........BBB...
.................BXXXB...........BBB...
.................BXXXB.....BBB.........
.................BXXXB.....BBB.........
2 2 2 2 2 2 2 3 3 1 1 1 1 0 0 0 0 0 0 0 