.........WWW...BBB......BBB...BBB......
.........WWW...BBB......BBB...BBB......
.........WWW...BBB......BBB...BBB......
........................BBB...SSS......
........................BBB...SSS......
........................BBB...SSS......
.........WWW......SSS...BBB...BBB......
.........WWW......SSS...BBB...BBB......
.........WWW...BBBSSS...BBB...BBB......
SSS...BBBWWW...SSS......BBB...BBB......
SSS...BBBWWW...SSS...BBB......BBB......
......BBBWWW...SSS...BBB......BBB......
......BBBWWW.........BBB...............
......BBBWWW.........BBB...............
......BBBWWW.........BBB...............
BBB...BBBWWWWWW...WWWWWWWWWWWW......BBB
BBB...BBBWWWWWW...WWWWWWWWWWWW......BBB
BBB...BBBWWWWWW...WWWWWWWWWWWW......BBB
.....................GGG...WWW...SSSSSS
.........BBB.........GGG...WWW.........
.........BBB.........GGG...WWW.........
BBBBBB..BBBB...SSSGGGGGGGGGWWW.........
BBBBBB..BBBB...SSSGGGGGGGGGWWW...BBBBBB
BBBBBB..BBBB...SSSGGGGGGGGGWWW...BBBBBB
BBB.....BB.....BBBGGGGGGGGGWWW...BBB...
........BB.....BBBGGGGGGGGGWWW...BBB...
........BB.....BBBGGGGGGGGGWWW...BBB...
...............BBB...GGG...WWW...GGG...
...SSS.........BBB...GGG...WWW...GGG...
...SSS.........BBB...GGG...WWW...GGG...
...BBB.........BBBBBBBBB......GGGGGGGGG
...BBB...SSS..................GGGGGGGGG
...BBB...SSS..................GGGGGGGGG
...BBB...BBB...............WWWGGGGGGGGG
...BBB...BBB...............WWWGGGGGGGGG
...BBB...BBB.....BBBBB.....WWWGGGGGGGGG
.................BXXXB.....WWW...GGG...
.................BXXXB.....WWW...GGG...
.................BXXXB.....WWW...GGG...
1 1 1 1 1 1 1 1 0 0 2 2 3 3 3 3 3 3 3 3 