.......................................
.......................................
.......................................
...............SSSSSS..................
...............SSSSSS..................
...............SSSSSS..................
..................SSS..................
..................SSS..................
..................SSS..................
...SSSSSSGGGGGGBBBSSSBBBGGGGGGSSSSSS...
...SSSSSSGGGGGGBBBSSSBBBGGGGGGSSSSSS...
...SSSSSSGGGGGGBBBSSSBBBGGGGGGSSSSSS...
.........SSSGGGGGGSSSGGGGGGSSS.........
.........SSSGGGGGGSSSGGGGGGSSS.........
.........SSSGGGGGGSSSGGGGGGSSS.........
GGG.........SSSGGGGGGGGGSSS.........GGG
GGG.........SSSGGGGGGGGGSSS.........GGG
GGG.........SSSGGGGGGGGGSSS.........GGG
SSSGGG.........GGGGGGGGG.........GGGSSS
SSSGGG.........GGGGGGGGG.........GGGSSS
SSSGGG.........GGGGGGGGG.........GGGSSS
GGG............SSSGGGSSS............GGG
GGG............SSSGGGSSS............GGG
GGG.........SSS...GGG...SSS.........GGG
............SSS.........SSS............
............SSS.........SSS............
............SSS...SSS...SSS............
.........SSS......SSS......SSS.........
.........SSS......SSS......SSS.........
.........SSS......SSS......SSS.........
.......................................
.......................................
.......................................
.......................................
.......................................
.................BBBBB.................
......SSS........BXXXB........SSS......
......SSS........BXXXB........SSS......
......SSS........BXXXB........SSS......
3 3 3 3 3 3 2 2 2 2 1 1 1 1 1 1 1 1 1 1 