............SSS........................
............SSS........................
............SSS........................
SSSSSS......SSS......SSSSSS............
SSSSSS......SSS......SSSSSS............
SSSSSS......SSS......SSSSSS............
...SSS......SSS.........SSS...SSSSSSGGG
...SSS......SSS.........SSS...SSSSSSGGG
...SSS......SSS.........SSS...SSSSSSGGG
...SSS......SSSSSSSSS...GGG...SSS......
...SSS......SSSSSSSSS...GGG...SSS......
...SSS......SSSSSSSSS...GGG...SSS......
...BBB............SSS...SSSSSSSSS......
...BBB............SSS...SSSSSSSSS......
...BBB............SSS...SSSSSSSSS......
GGGSSSSSS...SSSBBBSSSBBBBBB............
GGGSSSSSS...SSSBBBSSSBBBBBB............
GGGSSSSSS...SSSBBBSSSBBBBBB............
......SSSGGGSSSGGG......BBB......SSSSSS
......SSSGGGSSSGGG......BBB......SSSSSS
......SSSGGGSSSGGG......BBB......SSSSSS
......SSS......GGG......SSS......SSS...
......SSS......GGG......SSS......SSS...
......SSS......GGG......SSS......SSS...
......BBB......SSS......SSSSSSBBBSSS...
......BBB......SSS......SSSSSSBBBSSS...
......BBB......SSS......SSSSSSBBBSSS...
GGGSSSSSSSSSGGGGGGBBBSSSSSS...BBBSSS...
GGGSSSSSSSSSGGGGGGBBBSSSSSS...BBBSSS...
GGGSSSSSSSSSGGGGGGBBBSSSSSS...BBBSSS...
.........BBB............GGGGGG...BBB...
.........BBB............GGGGGG...BBB...
.........BBB............GGGGGG...BBB...
.........SSS...............GGG...BBB...
.........SSS...............GGG...BBB...
.........SSS.....BBBBB.....GGG...BBB...
.........SSS.....BXXXB.....SSS...BBB...
.........SSS.....BXXXB.....SSS...BBB...
.........SSS.....BXXXB.....SSS...BBB...
2 2 3 3 3 3 3 3 3 3 1 1 1 1 1 1 1 1 0 0 