...........B....B......................
...........BB...BB.....................
...........BB...BB......B..B...........
B..B..B...BB...BB.......BB.BB..........
BB.BB.BB..BB...BB.......BB.BB..........
BB.BB.BB..BB...BB.......BB.BBB.........
BB.BB.BB.BBBBBB.........BB.BBBBB.......
BB.BB.BB.BBBBBB.........BB.BBBBB.......
BB.BB.BB.BBBBBB.........BB.BBBBB.......
.BB.BB...BBBBB........BBBB.BBBBBB......
.BB.BB...BBBBBB.......BBBB.BBBBBB......
.BB.BB...BBBBBBB......BBBB.BBBBBB......
...BB....BBB..BBB....BB.BBBBBBBBB......
...BB....BBB..BBB....BB.BBBBBBBBB......
...BB....BBB..BBBB...BB.BBBBBBBBB......
...BB..BB......BBBB..BBB.BB.BBBBB......
...BB..BB......BBBB..BBB.BB.BBBBB......
...BB..BB......BBBB..BBB.BB.BBBBB......
...BB........BBBBBBBBBB....BB.BBB......
...BB........BBBBBBBBBB....BB.BBB......
...BB........BBBBBBBBBB....BB.BBB......
....BB......BB.BBBBBBBB....BB.BBB......
....BB......BB.BBBBBBBB....BB.BBB......
....BB.....BBB.BBBBBBBB....BB.BBB......
....BBBBBBBBB..BBBBBBBBB...BB.BB.BBBBBB
....BBBBBBBB...BBBBBBBBB...BB.BB.BBBBBB
....BB........BBBBBBBBBBB..BB.BB....BBB
....BB.......BBB.BBBBB.BBB.BB.BB..BB.BB
....BB.......BBB.BBBBB.BBB.BB.BB..BB.BB
....BB.......BBB.BBBBB.BBB.BB.BB..BB.BB
.....BB.....BBB..BBBB..BBBB.......BB...
.....BB.....BBB..BBB...BBBB.......BB...
.....BB.....BBB..BB....BBBB.......BB...
.....BB....BBB..........BBBBB....BB....
.....BB....BBB...........BBBB....BB....
.....BB....BBB...BBBBB...BBBB....BB....
.....BB....B.....BXXXB.....BBBBBB......
.....BB..BBB.....BXXXB.....BBBBBB......
.....BB..BBB.....BXXXB.....BBBBBB......
0 0 0 0 0 0 0 0 0 0 0 0 0 0 0 0 0 0 0 0 