......WWWWWW...........................
......WWWWWW...........................
......WWWWWW...........................
.........WWWGGG...B....................
.........WWWGGG...B....................
SSS......WWWGGG...B....................
GGG...............S.....B.....WWWWWW...
GGG...............S.....B.....WWWWWW...
GGGSSS............S.....B.....WWWWWW...
GGGGGG...........B......S..GGGWWW......
GGGGGG...SSS.....B......S..GGGWWW......
GGGGGG......BBB..B......S..GGGWWW......
GGGGGGGGG......SSS.....B...............
GGGGGGGGG......SSS.....B...............
GGGGGGGGG......SSSBBB..B............SSS
GGGGGGSSS........B...SSS............GGG
GGGGGG...SSS.....B...SSS............GGG
GGGGGG......BBB..B...SSSBBB......SSSGGG
GGGSSS.........SSS.....B...SSS...GGGGGG
GGG............SSS.....B.........GGGGGG
GGG............SSS.....B.........GGGGGG
...............B..BBBSSS......GGGGGGGGG
...............B.....SSS......GGGGGGGGG
...............B.....SSS......GGGGGGGGG
......WWWGGG..S......B..BBB...SSSGGGGGG
......WWWGGG..S......B.....SSS...GGGGGG
......WWWGGG..S......B...........GGGGGG
...WWWWWW.....B.....S...............GGG
...WWWWWW.....B.....S...............GGG
...WWWWWW.....B.....S...............GGG
....................B...GGGWWW......SSS
....................B...GGGWWW.........
....................B...GGGWWW.........
SSS........................WWWWWW......
SSS........................WWWWWW......
SSS..............BBBBB.....WWWWWW......
SSSSSS...........BXXXB..............SSS
SSSSSS...........BXXXB..............SSS
SSSSSS...........BXXXB..............SSS
1 1 1 1 1 1 3 3 3 3 3 3 0 0 0 0 2 2 2 2 