...............................SSS.....
...............................SSS.....
...............................SSS.....
..............................SSS......
..................SSS.........SSS......
..................SSS.........SSS......
..................GGG......BBBBB.......
...............BBBGGGBBB...BBBBB.......
...............BBBGGGBBB...BBBBB.......
...............GGGGGGGGG...BBBBB.......
............SSSGGGGGGGGGSSSBBBBB.......
............SSSGGGGGGGGGSSSBBBBB.......
............GGGGGG...GGGGGGBBBBB.......
.........BBBGGGGGG...GGGGGGBBBBB.......
.........BBBGGGGGG...GGGGGGBBBBB.......
.........GGGGGG.........GGGGGGBB.......
......SSSGGGGGG.........GGGGGGBB.......
......SSSGGGGGG.........GGGGGGBB.......
......GGGGGG...............GGGGGG......
...BBBGGGGGG...............GGGGGGBBB...
...BBBGGGGGG...............GGGGGGBBB...
...GGGGGG.....................GGGGGG...
SSSGGGGGG.....................GGGGGGSSS
SSSGGGGGG.....................GGGGGGSSS
GGGGGG...........................GGGGGG
GGGGGG...........................GGGGGG
GGGGGG...........................GGGGGG
...GGG...........................GGG...
...GGG...........................GGG...
...GGG...........................GGG...
...GGG...........................GGG...
...GGG...........................GGG...
...GGG...........................GGG...
...GGG...........................GGG...
...GGG...........................GGG...
...GGG...........BBBBB...........GGG...
...GGG...........BXXXB...........GGG...
...GGG...........BXXXB...........GGG...
...GGG...........BXXXB...........GGG...
1 1 3 0 0 0 0 0 0 0 0 0 0 0 0 0 0 0 3 3 