...............SSS...BBB...BBBBBB......
...............SSS...BBB...BBBBBB......
...............SSS...BBB...BBBBBB......
.....BBBBBBBBBBBBB...BBB...............
.....BBBBBBBBBBBBB...BBB...............
.....BBBBBBBBBBBBB...BBB...............
.........B.....BBB...BBBBBB...GGGGGGGGG
.........B.....BBB...BBBBBB...GGGGGGGGG
.........B.....BBB...BBBBBB...GGGGGGGGG
.....B...............SSS......GGGGGGGGG
.....B...............SSS...GGGGGGGGGGGG
.....B...............SSS...GGGGGGGGGGGG
.....B...BBBBBBBBBSSSBBBBBBGGGGGGBBBSSS
.....B...BBBBBBBBBSSSBBBBBBGGGGGG...SSS
.....B...BBBBBBBBBSSSBBBBBBGGGGGG...SSS
...BBBBBBBBBSSS......BBB...GGGGGG.....B
............SSS......BBB...GGGGGG.....B
............SSS......BBB...GGGGGG.....B
...BBBBBBBBB...SSSGGGGGGGGGGGGGGG......
...BBBBBBBBB...SSSGGGGGGGGGGGGGGG......
...BBBBBBBBB...SSSGGGGGGGGGGGGGGG......
.........SSS......GGGGGGGGGGGGGGGBBB...
.........SSS......GGGGGGGGGGGGGGGBBB...
.........SSS......GGGGGGGGGGGGGGGBBB...
SSSBBB...GGGGGGGGGGGGSSSGGGGGGGGGBBB...
SSSBBB...GGGGGGGGGGGGSSSGGGGGGGGGBBB...
SSSBBB...GGGGGGGGGGGGSSSGGGGGGGGGBBB...
..BBBBGGGGGGGGGGGGGGG............BBBB..
..BBBBGGGGGGGGGGGGGGG............BBBB..
..BBBBGGGGGGGGGGGGGGG............BBBB..
...BBBGGGGGG............SSSBBBBBBBBB...
...BBBGGGGGG............SSSBBBBBBBBB...
...BBBGGGGGG...............BBBBBBBBB...
......GGGGGG...............BBB.....B...
......GGGGGG...............BBB.....B...
......GGGGGG.....BBBBB.....BBB.....B...
......GGGGGG.....BXXXB.................
......GGGGGG.....BXXXB.................
......GGGGGG.....BXXXB.................
1 1 1 1 1 3 3 3 3 3 3 2 2 2 2 1 1 1 1 1 