..............................BBB......
..............................BBB......
..............................BBB......
...BBBWWWWWW...SSS...BBB...............
...BBBWWWWWW...SSS...BBB...............
...BBBWWWWWW...SSS...BBB...............
......WWWWWWBBBGGGGGGGGGWWWWWW...SSS...
......WWWWWWBBBGGGGGGGGGWWWWWW...SSS...
......WWWWWWBBBGGGGGGGGGWWWWWW...SSS...
................GGGGGGGGWWWWWWBBB......
................GGGGGGGGWWWWWWBBB......
................GGGGGGGGWWWWWWBBB......
...SSS......WWWWWW...GGG...............
...SSS......WWWWWW...GGG...............
...SSS......WWWWWW...GGG...............
GGGGGGBBB...WWWWWWSSS............BBB...
GGGGGGBBB...WWWWWWSSS............BBB...
GGGGGGBBB...WWWWWWSSS............BBB...
GGGGGGGGG..................SSS......SSS
GGGGGGGGG..................SSS......SSS
GGGGGGGGG..................SSS......SSS
...BBBWWWWWW...BBB.....................
...BBBWWWWWW...BBB.....................
...BBBWWWWWW...BBB.....................
SSS...WWWWWWGGGGGGWWWWWWGGGGGG...BBB...
SSS...WWWWWWGGGGGGWWWWWWGGGGGG...BBB...
SSS...WWWWWWGGGGGGWWWWWWGGGGGG...BBB...
............GGG...WWWWWWGGGGGGWWWWWW...
............GGG...WWWWWWGGGGGGWWWWWW...
............GGG...WWWWWWGGGGGGWWWWWW...
.........SSSGGG.........GGGGGGWWWWWW...
.........SSSGGG.........GGGGGGWWWWWW...
.........SSSGGG.........GGGGGGWWWWWW...
......BBB...BBB........................
......BBB...BBB........................
......BBB...BBB..BBBBB.................
BBB..............BXXXB.................
BBB..............BXXXB.................
BBB..............BXXXB.................
2 2 2 2 2 2 2 2 2 2 1 1 1 1 3 3 3 3 3 3 