.......................................
.......................................
.......................................
............BBB...BBB..................
............BBB...BBB..................
............BBB...BBB..................
GGG......GGGBBBGGGBBBGGGGGG...GGG......
GGG......GGGBBBGGGBBBGGGGGG...GGG......
GGG......GGGBBBGGGBBBGGGGGG...GGG......
BBBGGGGGGBBBBBBBBBBBBBBBGGGGGGBBBGGG...
BBBGGGGGGBBBBBBBBBBBBBBBGGGGGGBBBGGG...
BBBGGGGGGBBBBBBBBBBBBBBBGGGGGGBBBGGG...
BBBBBBBBBBBBSSSBBBSSSBBBBBBBBBBBBGGG...
BBBBBBBBBBBBSSSBBBSSSBBBBBBBBBBBBGGG...
BBBBBBBBBBBBSSSBBBSSSBBBBBBBBBBBBGGG...
WWWWWWWWWBBBBBBBBBBBBBBBWWWWWWWWWGGG...
WWWWWWWWWBBBBBBBBBBBBBBBWWWWWWWWWGGG...
WWWWWWWWWBBBBBBBBBBBBBBBWWWWWWWWWGGG...
WWWBBBBBBBBBBBBBBBBBBBBBBBBBBBWWWWWWGGG
WWWBBBBBBBBBBBBBBBBBBBBBBBBBBBWWWWWWGGG
WWWBBBBBBBBBBBBBBBBBBBBBBBBBBBWWWWWWGGG
BBBBBBBBBWWWBBBBBBBBBWWWBBBBBBBBBGGGGGG
BBBBBBBBBWWWBBBBBBBBBWWWBBBBBBBBBGGGGGG
BBBBBBBBBWWWBBBBBBBBBWWWBBBBBBBBBGGGGGG
BBBBBBWWWWWWWWWBBBWWWWWWWWWBBBBBBWWWWWW
BBBBBBWWWWWWWWWBBBWWWWWWWWWBBBBBBWWWWWW
BBBBBBWWWWWWWWWBBBWWWWWWWWWBBBBBBWWWWWW
GGGWWWWWWGGGGGGGGGGGGGGGWWWWWWGGGWWWGGG
GGGWWWWWWGGGGGGGGGGGGGGGWWWWWWGGGWWWGGG
GGGWWWWWWGGGGGGGGGGGGGGGWWWWWWGGGWWWGGG
...GGGGGG...............GGGGGG...GGG...
...GGGGGG...............GGGGGG...GGG...
...GGGGGG...............GGGGGG...GGG...
.......................................
.......................................
.................BBBBB.................
.................BXXXB.................
.................BXXXB.................
.................BXXXB.................
2 2 2 2 1 1 1 1 1 1 1 1 1 1 3 3 3 3 3 3 