...............GGG.....................
...............GGG.....................
...............GGG.....................
............GGGSSSGGG..................
............GGGSSSGGG..................
............GGGSSSGGG..................
......GGG......GGG......GGGGGG.........
......GGG......GGG......GGGGGG.........
......GGG......GGG......GGGGGG.........
...GGGBBBGGG.........GGGBBBBBBGGG......
...GGGBBBGGG.........GGGBBBBBBGGG......
...GGGBBBGGG.........GGGBBBBBBGGG......
......GGGBBBGGG.........GGGGGG......GGG
......GGGBBBGGG.........GGGGGG......GGG
......GGGBBBGGG.........GGGGGG......GGG
GGG......GGG.....................GGGSSS
GGG......GGG.....................GGGSSS
GGG......GGG.....................GGGSSS
BBBGGG........................GGG...GGG
BBBGGG........................GGG...GGG
BBBGGG........................GGG...GGG
SSSBBBGGG..................GGGSSSGGG...
SSSBBBGGG..................GGGSSSGGG...
SSSBBBGGG..................GGGSSSGGG...
BBBGGG......GGG.........GGG...GGG......
BBBGGG......GGG.........GGG...GGG......
BBBGGG......GGG.........GGG...GGG......
GGG......GGGBBBGGG...GGGBBBGGG.........
GGG......GGGBBBGGG...GGGBBBGGG.........
GGG......GGGBBBGGG...GGGBBBGGG.........
.........GGGBBBGGG......GGG......GGG...
.........GGGBBBGGG......GGG......GGG...
.........GGGBBBGGG......GGG......GGG...
...GGG......GGG...............GGGSSSGGG
...GGG......GGG...............GGGSSSGGG
...GGG......GGG..BBBBB........GGGSSSGGG
GGGSSSGGG........BXXXB.....GGGBBBGGG...
GGGSSSGGG........BXXXB.....GGGBBBGGG...
GGGSSSGGG........BXXXB.....GGGBBBGGG...
1 1 1 1 1 1 1 1 0 0 0 0 0 0 2 2 3 3 3 3 