.......................................
.......................................
.......................................
....BBBBBBBB..................BBBBBBBB.
....BBBBBBBB..................BBBBBBBB.
....BB...BBB..................BBB...BB.
.BBBBB......BBB...GGGGGG...BBB.......BB
.BBBBB......BBB...GGGGGG...BBB.......BB
.BB.........BBB...GGGGGG...BBB.......BB
BBB.........BBBGGGGGGGGGGGGBBB.......BB
BBB.........BBBGGGGGGGGGGGGBBB.......BB
BBB.........BBBGGGGGGGGGGGGBBB.......BB
BBB.......BBBBBGGGSSSSSSGGGBBBBB....BBB
BBB.......BBBBBGGGSSSSSSGGGBBBBB....BBB
BBB.......BBBBBGGGSSSSSSGGGBBBBB....BBB
.BB......BBBWWWWWWWWWWWWWWWWWWBBBBBBBBB
.BB......BBBWWWWWWWWWWWWWWWWWWBBBBBBBBB
.BBBBBBBBBBBWWWWWWWWWWWWWWWWWWBBBBBBBBB
..BBBBBBBBBBSSSSSSBBBSSSSSSBBBBBBBBBB..
...BBBBBBBBBSSSSSSBBBSSSSSSBBBBBBBBBB..
...BBBBBBBBBSSSSSSBBBSSSSSSBBBBBBBBBB..
......BBBBBBSSS...BBB...SSSBBBBBBB.....
......BBBBBBSSS...BBB...SSSBBBBBBB.....
......BBBBBBSSS...BBB...SSSBBBBBBB.....
......BBBBBBBBBBBBBBBBBBBBBBBBBBBB.....
......BBBBBBBBBBBBBBBBBBBBBBBBBBBB.....
......BBBBBBBBBBBBBBBBBBBBBBBBBBBB.....
BBBGGGBBBBBBBBBSSSSSSBBBBBBBBBBBBGGGBBB
BBBGGG.........SSSSSS............GGGBBB
BBBGGG.........SSSSSS............GGGBBB
BBBGGGGGGGGGGGGGGGGGGGGGGGGGGGGGGGGGBBB
BBBGGGGGGGGGGGGGGGGGGGGGGGGGGGGGGGGGBBB
BBBGGGGGGGGGGGGGGGGGGGGGGGGGGGGGGGGGBBB
......GGGGGGGGG.........GGGGGGGGGGGG...
......GGGGGGGGG.........GGGGGGGGGGGG...
......GGGGGGGGG..BBBBB..GGGGGGGGGGGG...
.........BB......BXXXB........BB.......
.........BB......BXXXB........BB.......
.........BB......BXXXB........BB.......
0 0 0 0 0 0 0 0 0 0 0 0 1 1 2 2 2 2 3 3 