.....................BBBBBBBBB.........
.....................BBBBBBBBB.........
.....................BBBBBBBBB.........
...BBBBBBBBB...............BBB.........
...BBBBBBBBBBBB...BBB......BBB.........
...BBBBBBBBBBBB...BBB......BBB.........
............BBB...BBB............BBBBBB
............BBB..................BBBBBB
............BBB..................BBBBBB
...WWWWWWWWWWWWWWW...............BBBSSS
...WWWWWWWWWWWWWWW...............BBBSSS
...WWWWWWWWWWWWWWW...............BBB...
...............WWW.........SSSSS.BBB...
......SSSSSSSSSWWW.........SSSSS.BBB...
......SSSSSSSSSWWW.........SSSSS.BBB...
BBB...BBBBBBBBBWWWWWWWWW...WWWBBBBBB...
BBB...BBBBBBBBBWWWWWWWWW...WWWBBBBBB...
BBB...BBBBBBBBBWWWWWWWWW...WWWBBBBBB...
............SSSWWW.........WWWSSS......
............SSSWWW.........WWWSSS......
............SSSWWW.........WWW.........
WWWWWWWWW...WWWWWW.........WWW.........
WWWWWWWWW...WWWWWW.........WWW.........
WWWWWWWWW...WWWWWW.........WWW.........
...........................WWWWWWWWW...
...........................WWWWWWWWW...
...........................WWWWWWWWW...
BBBBBBBBB..............................
BBBBBBBBB..............................
BBBBBBBBB..............................
......BBB..................BBBBBB....BB
......BBB..................BBBBBB....BB
......BBB..................BBBBBB....BB
BBB........................BBB......BBB
BBB........................BBB......BBB
BBB..............BBBBB.....BBB......BBB
.................BXXXB.................
.................BXXXB.................
.................BXXXB.................
2 2 2 2 2 2 2 2 1 1 1 1 1 1 3 3 3 3 3 3 