.......................................
............BBB...............BBB......
............BBB...............BBB......
...BBB...BBBBBB...............BBBBBB...
...BBB...BBBBBB...............BBBBBB...
...BBB...BBBBBB...............BBBBBB...
...BBB......BBB...SSS..................
...BBB......BBB...SSS..................
...BBB......BBB...SSS..................
.........SS.BBB......BBB...............
.........SS.BBB......BBB...............
.........SS.BBB......BBB...............
..................BBBBBB...............
..................BBBBBB...............
..................BBBBBB...............
.......SS............BBB.........SSSSSS
.......SS............BBB.........SSSSSS
.......SS............BBB...............
BBBBBBBBBBBB.....................BBBBBB
BBBBBBBBBBBB.....................BBBBBB
BBBBBBBBBBBB.....................BBBBBB
.........BBBBBB............SS..........
.........BBBBBB............SS..........
.........BBBBBB............SS..........
...BBBBBBBBB............BBBBBB...BBB...
...BBBBBBBBB............BBBBBB...BBB...
...BBBBBBBBB............BBBBBB...BBB...
.........BBB...............BBB...BBB...
.........BBB...............BBB...BBB...
.........BBB...............BBB...BBB...
...............SSS...SSS.........BBB...
...............SSS...SSS......BBBBBB...
..............................BBBBBB...
BBB........................BBB.........
BBB........................BBB.........
BBB..............BBBBB.....BBB.........
BBBBBBSS.........BXXXB.....BBB...BBB...
BBBBBBSS.........BXXXB.....BBB...BBB...
BBBBBBSS.........BXXXB.....BBB...BBB...
3 3 1 1 3 3 3 3 3 3 3 3 0 0 0 0 0 0 0 0 